NO ./texture/bluestone.xpm   
SO ./texture/greystone.xpm
WE ./texture/mossy.xpm
EA ./texture/redbrick.xpm
F 128,11,11
C 166,222,203

111111
1111111111
1W000001011111
100000001111111111
100011111111111
10101111111
11111111111
